date,text,retweets,replies,favorites,tweet_interactions
2010-06-04,1,121,37,407,565
2011-12-01,2,26,24,190,240
2011-12-03,2,29,2,34,65
2011-12-04,1,9,7,24,40
2011-12-21,7,637,36,1326,1999
2011-12-22,3,195,98,1122,1415
2011-12-24,3,3267,72,8188,11527
2011-12-26,6,185,40,537,762
2011-12-27,1,34,4,29,67
2011-12-28,1,0,2,5,7
2011-12-29,5,33,19,95,147
2011-12-30,8,51224,2038,180187,233449
2011-12-31,3,161,14,70,245
2012-01-01,7,78,24,160,262
2012-01-03,3,105,11,43,159
2012-01-06,3,116,38,37,191
2012-01-11,1,68,28,328,424
2012-01-12,3,135,31,124,290
2012-01-13,1,51,3,15,69
2012-01-14,2,23,5,11,39
2012-01-17,3,63,53,38,154
2012-01-18,1,445,195,7635,8275
2012-01-22,1,2,0,1,3
2012-01-23,1,9,15,15,39
2012-01-24,3,1303,184,18828,20315
2012-01-27,1,103,12,161,276
2012-01-28,2,114,19,25,158
2012-01-31,1,32,14,79,125
2012-02-01,2,68,25,86,179
2012-02-02,1,47,31,63,141
2012-02-04,2,112,19,59,190
2012-02-05,1,3,9,16,28
2012-02-06,2,225,32,99,356
2012-02-07,1,6,1,1,8
2012-02-08,3,110,24,115,249
2012-02-09,2,157,48,156,361
2012-02-10,4,1159,211,4233,5603
2012-02-12,1,21,30,179,230
2012-02-14,1,56,15,13,84
2012-02-17,1,29,4,3,36
2012-02-21,1,27,6,14,47
2012-02-22,1,168,9,132,309
2012-02-25,3,253,42,91,386
2012-02-28,1,131,17,49,197
2012-02-29,1,1,5,10,16
2012-03-02,1,19,6,19,44
2012-03-07,1,82,31,296,409
2012-03-11,2,27,34,80,141
2012-03-12,1,52,10,38,100
2012-03-13,1,38,6,19,63
2012-03-14,1,54,2,12,68
2012-03-15,2,293,42,301,636
2012-03-20,1,39,3,4,46
2012-03-22,1,28,3,31,62
2012-03-28,1,171,26,29,226
2012-03-31,2,11,15,38,64
2012-04-01,1,9,0,2,11
2012-04-03,2,358,53,772,1183
2012-04-04,1,6,7,1,14
2012-04-05,2,64,11,83,158
2012-04-09,3,159,31,82,272
2012-04-11,1,39,31,14,84
2012-04-14,1,7,5,11,23
2012-04-18,1,687,114,3061,3862
2012-04-19,2,159,25,71,255
2012-04-21,1,21,5,55,81
2012-04-22,1,7,0,1,8
2012-04-23,2,221,48,42,311
2012-04-24,1,455,30,53,538
2012-04-30,4,531,92,161,784
2012-05-03,3,287,28,127,442
2012-05-05,2,144,27,56,227
2012-05-08,1,46,10,16,72
2012-05-09,1,103,23,23,149
2012-05-10,1,43,18,16,77
2012-05-11,3,249,68,66,383
2012-05-14,1,44,16,26,86
2012-05-19,2,746,141,92,979
2012-05-20,2,253,46,66,365
2012-05-22,9,3266,704,851,4821
2012-05-23,1,210,25,27,262
2012-05-24,4,3064,250,1025,4339
2012-05-25,2,751,155,224,1130
2012-05-31,4,1230,193,263,1686
2012-06-05,1,130,17,26,173
2012-06-14,2,72,22,28,122
2012-06-16,1,325,21,138,484
2012-06-18,2,511,107,596,1214
2012-06-20,1,5,5,5,15
2012-06-22,2,341,70,120,531
2012-06-27,3,158,23,90,271
2012-06-28,1,47,9,32,88
2012-06-30,1,382,40,132,554
2012-07-01,2,82,72,72,226
2012-07-05,2,272,98,222,592
2012-07-07,1,297,82,181,560
2012-07-12,2,65,22,27,114
2012-07-14,1,125,56,195,376
2012-07-15,2,556,84,358,998
2012-07-17,1,88,31,17,136
2012-07-21,3,247,51,152,450
2012-07-23,2,616,41,141,798
2012-07-27,7,400,80,400,880
2012-07-31,3,2221,450,36110,38781
2012-08-01,6,1025,247,7669,8941
2012-08-03,3,503,91,200,794
2012-08-04,1,6,2,8,16
2012-08-13,1,32,75,19,126
2012-08-22,2,468,88,317,873
2012-08-25,1,814,34,206,1054
2012-08-27,3,394,51,112,557
2012-08-29,2,269,21,146,436
2012-09-06,1,219,27,62,308
2012-09-13,1,326,20,291,637
2012-09-14,1,360,54,103,517
2012-09-17,1,293,91,139,523
2012-09-19,1,107,13,26,146
2012-09-22,1,191,38,87,316
2012-09-24,1,122,23,63,208
2012-09-25,1,874,77,253,1204
2012-09-30,1,635,100,325,1060
2012-10-01,2,181,30,98,309
2012-10-02,1,593,61,155,809
2012-10-03,1,5,8,6,19
2012-10-04,1,338,37,104,479
2012-10-07,1,114,15,47,176
2012-10-08,1,740,139,191,1070
2012-10-11,1,347,36,237,620
2012-10-22,1,141,17,67,225
2012-10-28,5,678,192,676,1546
2012-11-03,2,223,42,129,394
2012-11-06,1,46,13,60,119
2012-11-07,1,212,31,144,387
2012-11-12,1,102,16,85,203
2012-11-13,1,74,9,47,130
2012-11-16,2,175,47,69,291
2012-11-19,1,48,36,77,161
2012-11-20,5,427,110,229,766
2012-11-21,2,357,87,375,819
2012-11-22,2,174,34,129,337
2012-11-23,2,200,28,276,504
2012-11-24,1,2,1,9,12
2012-11-25,1,209,27,138,374
2012-11-27,3,1141,317,452,1910
2012-11-28,1,684,126,607,1417
2012-11-29,1,2,3,3,8
2012-12-02,1,699,68,151,918
2012-12-04,1,708,124,358,1190
2012-12-05,1,165,48,120,333
2012-12-09,2,296,73,182,551
2012-12-11,1,217,53,104,374
2012-12-12,7,361,92,200,653
2012-12-14,5,233,55,99,387
2012-12-17,1,338,20,198,556
2012-12-19,2,142,36,96,274
2012-12-24,4,906,137,643,1686
2012-12-25,2,3,5,5,13
2012-12-29,2,166,37,60,263
2013-01-04,2,457,67,218,742
2013-01-10,2,245,105,145,495
2013-01-15,1,177,42,119,338
2013-01-18,1,579,71,245,895
2013-01-26,1,207,35,108,350
2013-01-30,1,357,45,152,554
2013-02-04,3,1783,127,1025,2935
2013-02-08,3,288,62,172,522
2013-02-09,1,222,60,98,380
2013-02-10,1,57,9,28,94
2013-02-11,6,1663,338,672,2673
2013-02-14,1,91,42,86,219
2013-02-15,2,150,44,76,270
2013-02-16,1,386,77,183,646
2013-02-18,1,96,34,49,179
2013-02-19,1,99,12,50,161
2013-02-23,1,9,6,13,28
2013-02-25,1,5,1,4,10
2013-02-26,1,252,25,184,461
2013-02-27,3,555,62,158,775
2013-03-01,15,5429,1021,2134,8584
2013-03-02,1,331,60,152,543
2013-03-06,1,214,72,121,407
2013-03-08,9,576,230,451,1257
2013-03-09,2,559,162,256,977
2013-03-10,1,206,46,287,539
2013-03-17,2,72,18,46,136
2013-03-19,1,232,40,158,430
2013-03-20,3,733,112,710,1555
2013-03-23,9,663,266,412,1341
2013-03-24,2,5,5,17,27
2013-03-25,2,1048,199,386,1633
2013-03-26,6,921,223,505,1649
2013-03-29,3,505,113,358,976
2013-03-30,3,681,162,154,997
2013-03-31,2,68,36,74,178
2013-04-01,4,641,175,392,1208
2013-04-02,8,342,127,280,749
2013-04-03,2,200,65,101,366
2013-04-08,4,826,530,745,2101
2013-04-09,9,453,367,649,1469
2013-04-10,2,54,25,54,133
2013-04-11,6,798,235,606,1639
2013-04-13,1,208,107,112,427
2013-04-17,2,516,103,139,758
2013-04-18,2,187,23,153,363
2013-04-21,1,128,12,69,209
2013-04-22,3,616,140,752,1508
2013-04-23,8,1793,432,713,2938
2013-04-24,2,5,4,10,19
2013-04-25,5,449,154,371,974
2013-04-26,2,1,5,11,17
2013-04-28,1,439,87,350,876
2013-04-30,2,374,43,221,638
2013-05-01,5,3,8,23,34
2013-05-02,6,429,201,359,989
2013-05-03,13,224,118,199,541
2013-05-04,4,15,6,25,46
2013-05-05,4,16,7,21,44
2013-05-06,3,553,274,262,1089
2013-05-07,5,513,223,416,1152
2013-05-08,2,480,224,461,1165
2013-05-09,4,513,390,328,1231
2013-05-12,11,490,227,444,1161
2013-05-13,5,65,46,100,211
2013-05-14,2,127,135,109,371
2013-05-15,1,18,7,22,47
2013-05-18,2,114,120,236,470
2013-05-19,2,4,5,18,27
2013-05-20,2,28,42,149,219
2013-05-22,1,1841,251,760,2852
2013-05-23,3,481,159,432,1072
2013-05-24,6,1236,271,617,2124
2013-05-25,33,4019,2085,3237,9341
2013-05-26,2,142,59,95,296
2013-05-30,2,674,250,355,1279
2013-06-03,4,1780,297,1403,3480
2013-06-05,1,1071,233,1384,2688
2013-06-06,4,1022,270,776,2068
2013-06-08,2,235,69,191,495
2013-06-10,1,256,64,160,480
2013-06-12,2,324,159,254,737
2013-06-18,4,696,219,363,1278
2013-06-19,1,122,136,96,354
2013-06-20,1,436,106,341,883
2013-06-21,2,221,85,118,424
2013-06-24,1,0,3,3,6
2013-06-25,3,3,10,15,28
2013-06-28,3,941,120,226,1287
2013-06-29,1,749,96,264,1109
2013-06-30,1,50,25,87,162
2013-07-02,1,594,122,477,1193
2013-07-06,1,1787,314,689,2790
2013-07-09,2,2242,212,1471,3925
2013-07-10,2,556,49,279,884
2013-07-15,5,3170,641,1794,5605
2013-07-23,1,856,237,553,1646
2013-07-24,1,326,40,219,585
2013-07-28,1,427,158,281,866
2013-08-01,1,471,46,280,797
2013-08-07,1,215,56,205,476
2013-08-12,3,8301,1255,3919,13475
2013-08-14,1,1186,280,592,2058
2013-08-16,1,694,199,413,1306
2013-08-20,1,2118,382,914,3414
2013-08-23,4,3835,838,2211,6884
2013-08-24,1,328,70,330,728
2013-09-04,1,251,81,289,621
2013-09-05,2,2984,550,1769,5303
2013-09-06,1,398,114,264,776
2013-09-07,1,897,283,486,1666
2013-09-10,3,1044,238,741,2023
2013-09-13,1,89,40,60,189
2013-09-15,1,136,53,119,308
2013-09-18,3,2888,466,1460,4814
2013-09-19,2,1173,278,1127,2578
2013-09-20,2,743,139,458,1340
2013-09-25,2,637,129,342,1108
2013-09-26,1,236,43,175,454
2013-09-27,1,646,86,280,1012
2013-09-29,6,2967,669,2063,5699
2013-10-04,1,1260,309,591,2160
2013-10-12,1,1847,398,897,3142
2013-10-26,1,272,134,660,1066
2013-10-30,1,437,69,202,708
2013-11-02,1,350,58,435,843
2013-11-10,1,750,131,379,1260
2013-11-12,1,1020,223,1013,2256
2013-11-14,1,478,88,529,1095
2013-11-19,4,6088,1818,3571,11477
2013-11-21,1,692,122,430,1244
2013-11-23,4,801,230,821,1852
2013-11-24,1,136,74,348,558
2013-11-26,1,306,116,251,673
2013-11-28,12,3184,697,2306,6187
2013-11-29,1,45,28,45,118
2013-11-30,2,440,95,299,834
2013-12-02,4,1187,260,960,2407
2013-12-03,9,1435,455,1332,3222
2013-12-04,1,2031,252,1565,3848
2013-12-05,3,1243,184,1071,2498
2013-12-10,1,190,46,134,370
2013-12-19,2,372,106,487,965
2013-12-21,2,1636,215,1107,2958
2013-12-22,1,11,6,16,33
2013-12-25,1,3,1,11,15
2013-12-26,1,4,30,13,47
2014-01-06,2,419,108,462,989
2014-01-07,1,309,95,298,702
2014-01-23,1,567,184,557,1308
2014-01-26,3,1676,304,1709,3689
2014-01-30,1,1142,264,1220,2626
2014-02-02,1,1244,228,1125,2597
2014-02-07,1,533,89,463,1085
2014-02-09,2,973,269,1506,2748
2014-02-11,1,647,195,315,1157
2014-02-14,1,166,28,209,403
2014-02-24,2,1369,213,1425,3007
2014-02-25,2,1821,279,1890,3990
2014-03-05,1,473,182,844,1499
2014-03-07,1,16,26,37,79
2014-03-10,1,9,7,34,50
2014-03-11,2,1741,259,945,2945
2014-03-14,6,3405,652,3197,7254
2014-03-17,1,1082,279,378,1739
2014-03-19,1,3,8,26,37
2014-03-25,1,11,11,74,96
2014-03-31,3,336,260,1317,1913
2014-04-01,1,681,124,629,1434
2014-04-05,4,483,90,725,1298
2014-04-07,7,822,253,1267,2342
2014-04-08,3,1091,285,1312,2688
2014-04-17,1,653,103,950,1706
2014-04-18,9,3623,582,3890,8095
2014-04-19,2,1437,308,1662,3407
2014-04-24,2,641,94,771,1506
2014-04-26,1,252,64,339,655
2014-04-29,6,1955,252,2352,4559
2014-05-02,2,1615,350,1316,3281
2014-05-08,1,557,142,278,977
2014-05-10,1,106,41,300,447
2014-05-14,2,3072,506,5368,8946
2014-05-22,1,363,41,500,904
2014-05-23,8,3292,461,2931,6684
2014-05-24,2,42,18,110,170
2014-05-25,1,1504,121,2181,3806
2014-05-29,2,507,80,666,1253
2014-05-31,1,556,115,555,1226
2014-06-04,1,261,84,358,703
2014-06-11,1,4,7,32,43
2014-06-12,2,8687,1483,6670,16840
2014-06-17,3,3591,504,3862,7957
2014-06-19,1,722,181,762,1665
2014-07-01,1,446,69,575,1090
2014-07-10,2,724,131,791,1646
2014-07-14,3,1598,318,1862,3778
2014-07-19,1,136,99,251,486
2014-07-23,1,488,81,551,1120
2014-07-26,1,110,168,581,859
2014-08-03,6,8573,1431,9976,19980
2014-08-05,4,3398,311,4564,8273
2014-08-15,3,2253,383,2388,5024
2014-08-19,1,984,115,906,2005
2014-08-23,2,2572,599,3971,7142
2014-08-25,4,543,191,931,1665
2014-09-01,1,1262,194,1149,2605
2014-09-07,4,5667,438,6476,12581
2014-09-08,2,1499,158,2428,4085
2014-09-09,2,1361,225,3189,4775
2014-09-10,1,0,3,36,39
2014-09-11,1,1516,281,1914,3711
2014-09-16,3,2748,343,4313,7404
2014-09-20,2,355,103,643,1101
2014-09-29,1,408,52,476,936
2014-10-02,2,13843,2485,13155,29483
2014-10-09,1,1089,259,2137,3485
2014-10-11,1,1295,223,1437,2955
2014-10-16,1,1129,144,2822,4095
2014-10-17,1,685,147,435,1267
2014-10-18,1,564,66,708,1338
2014-10-26,1,2084,454,4442,6980
2014-10-28,3,1925,359,3095,5379
2014-10-31,1,1174,79,1818,3071
2014-11-04,1,618,102,734,1454
2014-11-07,1,521,95,600,1216
2014-11-11,2,2283,268,2604,5155
2014-11-18,1,677,111,1318,2106
2014-11-19,2,3069,420,5521,9010
2014-11-21,2,1194,169,1842,3205
2014-11-22,4,1961,309,3195,5465
2014-11-23,3,481,140,780,1401
2014-11-24,1,120,102,344,566
2014-12-08,2,1087,449,2654,4190
2014-12-19,4,2486,317,3229,6032
2014-12-20,2,3116,395,5131,8642
2014-12-25,1,1757,208,2494,4459
2014-12-26,2,751,261,1731,2743
2014-12-30,1,353,49,527,929
2014-12-31,1,4394,550,5082,10026
2015-01-05,2,4420,467,4319,9206
2015-01-06,3,2337,396,2661,5394
2015-01-10,11,16385,2321,21401,40107
2015-01-11,1,1585,172,1584,3341
2015-01-12,1,3541,216,5873,9630
2015-01-15,4,6824,782,7537,15143
2015-01-16,6,8304,754,9346,18404
2015-01-17,1,10,12,76,98
2015-01-20,1,2850,383,3199,6432
2015-01-23,5,3504,491,5386,9381
2015-01-26,5,6048,1319,11591,18958
2015-01-28,1,1650,195,1734,3579
2015-01-29,5,8344,1092,12082,21518
2015-01-30,1,465,245,810,1520
2015-02-08,4,6195,907,8570,15672
2015-02-10,3,1605,554,2338,4497
2015-02-11,8,11048,1798,20503,33349
2015-02-12,1,1489,244,2686,4419
2015-02-24,1,1688,188,2120,3996
2015-02-26,1,1611,201,2119,3931
2015-03-02,3,1593,268,3575,5436
2015-03-07,1,623,132,1110,1865
2015-03-08,1,566,91,1320,1977
2015-03-11,1,973,146,1331,2450
2015-03-12,3,13837,1911,18506,34254
2015-03-13,3,2041,518,3850,6409
2015-03-14,1,1768,316,1442,3526
2015-03-15,1,1004,103,1407,2514
2015-03-16,2,1277,303,3648,5228
2015-03-17,3,2260,691,4594,7545
2015-03-18,1,711,168,1661,2540
2015-03-21,4,1742,225,3068,5035
2015-03-22,1,218,243,917,1378
2015-03-23,2,2742,638,5464,8844
2015-03-24,4,3574,829,6461,10864
2015-03-30,1,6440,1035,5451,12926
2015-03-31,2,2090,641,3756,6487
2015-04-01,1,1677,377,2061,4115
2015-04-04,1,1496,572,2705,4773
2015-04-06,3,1325,279,3050,4654
2015-04-09,1,416,69,761,1246
2015-04-11,4,2653,564,4723,7940
2015-04-12,1,5,2,35,42
2015-04-13,4,2922,734,5121,8777
2015-04-14,3,15159,2561,14946,32666
2015-04-15,4,18112,1898,25688,45698
2015-04-18,2,1475,300,2850,4625
2015-04-19,2,1024,250,1794,3068
2015-04-23,1,50,31,156,237
2015-04-27,2,1702,383,4374,6459
2015-04-29,1,4223,964,5152,10339
2015-04-30,1,14,16,110,140
2015-05-01,2,1262,183,1572,3017
2015-05-02,1,3061,348,3722,7131
2015-05-03,2,2740,390,5322,8452
2015-05-04,1,2447,187,2444,5078
2015-05-05,1,1796,162,3026,4984
2015-05-06,3,2718,444,5040,8202
2015-05-12,6,3398,691,7672,11761
2015-05-19,2,2653,305,2511,5469
2015-05-22,3,1179,1046,2034,4259
2015-05-27,1,1201,237,2345,3783
2015-06-01,1,39,37,234,310
2015-06-12,1,141,53,667,861
2015-06-15,2,974,120,2070,3164
2015-06-19,1,852,143,1693,2688
2015-06-23,1,824,143,1638,2605
2015-06-27,6,3004,418,4832,8254
2015-06-28,6,9881,1740,9609,21230
2015-06-29,1,2330,673,3601,6604
2015-07-06,1,1047,223,2064,3334
2015-07-17,1,779,143,1673,2595
2015-07-18,1,1187,224,2206,3617
2015-07-27,1,53,20,140,213
2015-07-28,2,3244,394,3046,6684
2015-07-30,2,114,15,174,303
2015-07-31,6,4107,585,7880,12572
2015-08-06,1,2349,349,2975,5673
2015-08-08,1,70,38,294,402
2015-08-16,1,890,144,1565,2599
2015-08-17,1,1578,114,2337,4029
2015-08-22,2,2303,338,4599,7240
2015-09-02,6,7542,1088,11673,20303
2015-09-12,2,3977,616,7563,12156
2015-09-13,1,1192,160,2239,3591
2015-09-14,3,4100,463,8193,12756
2015-09-23,2,838,363,3598,4799
2015-09-25,1,419,141,1762,2322
2015-09-27,1,1591,131,1848,3570
2015-09-29,2,3782,379,5572,9733
2015-09-30,1,758,233,2069,3060
2015-10-02,8,2429,475,5037,7941
2015-10-03,1,1824,244,3980,6048
2015-10-09,4,4536,745,8685,13966
2015-10-10,2,1212,167,2089,3468
2015-10-11,10,2545,374,4959,7878
2015-10-14,2,21,10,90,121
2015-10-15,3,933,106,3644,4683
2015-10-17,2,196,41,1263,1500
2015-10-19,1,847,179,1897,2923
2015-10-21,12,2233,2652,5944,10829
2015-10-22,3,91,154,682,927
2015-10-23,4,2543,373,4967,7883
2015-10-25,7,1379,326,3957,5662
2015-10-26,3,537,127,1793,2457
2015-10-27,1,235,91,1310,1636
2015-10-29,2,1333,181,2251,3765
2015-10-30,1,6,2,64,72
2015-11-01,1,60,21,390,471
2015-11-02,1,33,16,226,275
2015-11-04,1,16,33,163,212
2015-11-08,1,32,18,163,213
2015-11-20,6,7828,1379,12586,21793
2015-11-24,8,6007,679,12967,19653
2015-12-02,1,332,115,1092,1539
2015-12-03,1,1576,183,2364,4123
2015-12-04,1,25,10,160,195
2015-12-06,1,146,25,742,913
2015-12-09,1,700,61,1666,2427
2015-12-10,2,1324,217,3459,5000
2015-12-11,1,3678,246,4358,8282
2015-12-17,1,521,84,1117,1722
2015-12-18,11,2310,783,8542,11635
2015-12-19,4,3085,597,8399,12081
2015-12-20,1,1098,202,2590,3890
2015-12-21,1,1818,229,2866,4913
2015-12-22,8,52384,3768,92186,148338
2016-01-01,1,4803,534,10270,15607
2016-01-02,1,874,260,3018,4152
2016-01-10,3,8981,1011,15355,25347
2016-01-11,1,1127,127,4365,5619
2016-01-12,2,2837,330,6382,9549
2016-01-16,2,1567,322,5547,7436
2016-01-17,10,12451,2286,28432,43169
2016-01-18,2,8227,1288,9802,19317
2016-01-19,1,1440,394,5176,7010
2016-01-20,1,47,53,244,344
2016-01-23,1,268,72,1267,1607
2016-02-03,1,2338,970,9236,12544
2016-02-05,1,1877,295,5099,7271
2016-02-10,2,1945,247,5289,7481
2016-02-11,6,4910,854,11745,17509
2016-02-16,3,4355,575,10523,15453
2016-02-17,1,13,14,81,108
2016-02-18,4,1709,354,8788,10851
2016-02-19,3,8996,1081,11223,21300
2016-02-20,1,747,34,3511,4292
2016-02-21,3,2018,282,7185,9485
2016-02-23,1,53,18,140,211
2016-02-24,2,5054,498,7678,13230
2016-02-27,4,40,20,317,377
2016-02-28,2,1130,227,2037,3394
2016-02-29,1,1823,310,2463,4596
2016-03-01,3,1618,238,4130,5986
2016-03-02,4,2068,355,5949,8372
2016-03-04,1,73,23,225,321
2016-03-05,3,6067,993,17022,24082
2016-03-06,2,3797,337,10243,14377
2016-03-09,3,2392,393,7525,10310
2016-03-18,2,11,13,144,168
2016-03-19,1,11,12,88,111
2016-03-20,1,967,168,2638,3773
2016-03-29,1,2556,616,8835,12007
2016-03-30,5,6290,651,14269,21210
2016-03-31,11,11034,1988,26154,39176
2016-04-01,14,26707,2890,55531,85128
2016-04-02,12,10662,2465,35121,48248
2016-04-03,37,13569,4280,48023,65872
2016-04-04,8,567,448,5337,6352
2016-04-05,3,1707,280,6743,8730
2016-04-06,6,394,186,2324,2904
2016-04-07,2,4365,670,9711,14746
2016-04-08,7,5380,708,21150,27238
2016-04-09,4,7079,1431,36441,44951
2016-04-10,1,95,34,704,833
2016-04-11,3,1255,291,5839,7385
2016-04-14,1,3074,224,5455,8753
2016-04-17,4,3575,553,11198,15326
2016-04-18,1,1025,165,2897,4087
2016-04-20,5,4960,534,17818,23312
2016-04-24,1,175,9,167,351
2016-04-27,5,5479,688,14099,20266
2016-04-29,3,30,26,262,318
2016-04-30,17,1728,343,6282,8353
2016-05-01,9,1510,306,6100,7916
2016-05-02,2,3744,520,9920,14184
2016-05-05,2,2343,462,7098,9903
2016-05-06,6,17160,1809,51399,70368
2016-05-07,4,473,224,3196,3893
2016-05-10,1,6,9,95,110
2016-05-12,5,4836,751,14252,19839
2016-05-14,3,1517,258,5806,7581
2016-05-15,2,4356,475,16997,21828
2016-05-16,7,1245,348,5886,7479
2016-05-17,1,10,3,103,116
2016-05-18,5,2467,313,9274,12054
2016-05-19,1,792,95,2284,3171
2016-05-22,1,52,18,272,342
2016-05-25,1,1317,124,3575,5016
2016-05-26,1,742,128,2277,3147
2016-05-27,4,3272,698,14173,18143
2016-05-28,2,9899,747,15520,26166
2016-05-29,1,1096,109,4385,5590
2016-05-30,1,7,43,148,198
2016-06-01,1,1090,91,2597,3778
2016-06-02,3,1560,400,4390,6350
2016-06-03,3,17974,1135,33671,52780
2016-06-04,7,7321,2657,20980,30958
2016-06-05,3,4186,499,12277,16962
2016-06-06,1,525,84,2194,2803
2016-06-07,1,2357,242,8741,11340
2016-06-08,3,1980,286,7471,9737
2016-06-09,2,5031,456,11855,17342
2016-06-10,5,3454,1061,12358,16873
2016-06-11,1,20,147,192,359
2016-06-12,8,6454,961,18324,25739
2016-06-15,6,6601,1170,21450,29221
2016-06-17,4,15837,1181,41266,58284
2016-06-19,4,11004,1113,28215,40332
2016-06-20,2,965,182,3700,4847
2016-06-22,1,164,89,788,1041
2016-06-27,4,1199,471,5173,6843
2016-06-28,1,355,1028,5909,7292
2016-06-29,4,1976,345,6473,8794
2016-06-30,2,1660,408,4326,6394
2016-07-05,5,1186,555,5395,7136
2016-07-06,7,2248,351,6306,8905
2016-07-08,4,2200,181,6363,8744
2016-07-09,3,900,165,4777,5842
2016-07-10,21,18402,2004,58875,79281
2016-07-12,3,1568,307,6534,8409
2016-07-13,1,1644,235,5111,6990
2016-07-14,4,6627,571,16900,24098
2016-07-15,11,2812,679,11301,14792
2016-07-16,7,2127,750,9765,12642
2016-07-17,12,6295,1029,23965,31289
2016-07-18,8,11731,1837,43811,57379
2016-07-19,3,2350,1055,14074,17479
2016-07-20,9,4054,1733,22588,28375
2016-07-21,6,20334,1678,43707,65719
2016-07-22,1,1739,553,9392,11684
2016-07-23,1,818,204,3803,4825
2016-07-25,1,19,20,269,308
2016-07-26,3,7511,605,15277,23393
2016-07-27,2,2611,353,10960,13924
2016-07-28,1,568,86,1973,2627
2016-07-29,3,3974,652,12517,17143
2016-07-30,7,9000,1026,32977,43003
2016-07-31,2,134,70,741,945
2016-08-01,1,27,96,392,515
2016-08-07,1,2156,472,9474,12102
2016-08-09,4,3454,479,14552,18485
2016-08-10,1,2597,163,6407,9167
2016-08-11,1,291,107,2244,2642
2016-08-14,1,1894,548,10605,13047
2016-08-15,1,1229,227,3102,4558
2016-08-22,1,2159,144,6221,8524
2016-08-23,2,4918,919,14695,20532
2016-08-28,2,147,64,836,1047
2016-08-30,1,1949,147,7706,9802
2016-08-31,5,2146,409,10674,13229
2016-09-01,3,5736,1660,15235,22631
2016-09-09,10,7648,2048,25722,35418
2016-09-10,1,896,338,5645,6879
2016-09-13,4,14714,804,26028,41546
2016-09-16,6,2103,316,5900,8319
2016-09-17,8,2315,2673,11734,16722
2016-09-18,2,1632,283,5574,7489
2016-09-19,1,14,29,158,201
2016-09-21,11,4522,781,20887,26190
2016-09-22,4,8774,758,24243,33775
2016-09-23,1,1270,143,3608,5021
2016-09-26,9,14297,1034,42382,57713
2016-09-27,6,11780,1461,26027,39268
2016-09-28,4,353,116,2034,2503
2016-10-01,2,277,52,1332,1661
2016-10-02,6,3401,731,17794,21926
2016-10-04,2,1840,377,6556,8773
2016-10-05,2,1239,335,4300,5874
2016-10-06,2,82,85,843,1010
2016-10-07,3,2874,573,10758,14205
2016-10-09,5,6138,931,18905,25974
2016-10-10,8,15997,1564,41328,58889
2016-10-13,1,30,22,277,329
2016-10-16,3,1963,717,9082,11762
2016-10-18,1,210,55,936,1201
2016-10-19,5,8387,1763,22254,32404
2016-10-20,15,25498,3179,62186,90863
2016-10-22,1,5732,443,10277,16452
2016-10-23,2,1138,327,6123,7588
2016-10-24,1,14,37,312,363
2016-10-26,2,2539,1005,26730,30274
2016-10-27,4,3310,727,13691,17728
2016-10-29,6,8666,1830,32089,42585
2016-11-02,1,11,12,149,172
2016-11-03,4,3279,367,7018,10664
2016-11-04,25,6966,1644,37335,45945
2016-11-05,7,613,199,4057,4869
2016-11-06,1,5246,714,21231,27191
2016-11-07,1,25,29,289,343
2016-11-15,1,2004,304,9346,11654
2016-11-16,5,4580,786,18684,24050
2016-11-17,2,2759,470,15747,18976
2016-11-18,1,45,31,281,357
2016-11-19,7,8398,971,18224,27593
2016-11-22,5,4752,835,16888,22475
2016-11-23,2,25,106,371,502
2016-11-27,1,40,38,336,414
2016-12-01,1,5834,544,15151,21529
2016-12-07,1,4594,651,9719,14964
2016-12-08,1,2812,138,11564,14514
2016-12-09,1,11891,800,34035,46726
2016-12-11,2,250,262,2644,3156
2016-12-17,5,25621,5657,96193,127471
2016-12-18,2,83,60,1008,1151
2016-12-21,1,3,11,193,207
2016-12-22,2,5338,932,24639,30909
2016-12-23,9,872,273,6222,7367
2016-12-24,15,6395,1059,26057,33511
2016-12-30,2,683,159,2511,3353
2016-12-31,4,1559,627,11402,13588
2017-01-05,1,3039,492,14760,18291
2017-01-06,1,84,28,262,374
2017-01-07,1,26,16,265,307
2017-01-08,3,1595,398,9837,11830
2017-01-10,1,32,36,271,339
2017-01-11,3,359,139,2456,2954
2017-01-12,8,2809,652,15884,19345
2017-01-14,2,6614,1176,37247,45037
2017-01-15,3,9526,805,42067,52398
2017-01-16,6,1257,443,9122,10822
2017-01-18,1,832,191,4137,5160
2017-01-19,8,4222,479,18090,22791
2017-01-21,6,2346,591,14713,17650
2017-01-22,8,1025,313,6364,7702
2017-01-23,1,30,13,317,360
2017-01-24,6,5323,769,14439,20531
2017-01-25,14,20936,4392,66042,91370
2017-01-27,2,5981,1258,21490,28729
2017-01-28,2,3208,632,12720,16560
2017-01-29,6,33196,6633,102461,142290
2017-01-30,6,14466,2381,33385,50232
2017-01-31,1,60,88,619,767
2017-02-02,1,46,53,559,658
2017-02-03,1,22714,4895,77702,105311
2017-02-04,17,30147,6150,146225,182522
2017-02-05,42,18990,5595,92104,116689
2017-02-07,9,7944,1085,23137,32166
2017-02-08,4,1492,347,4661,6500
2017-02-09,1,8,13,224,245
2017-02-10,3,2125,403,10230,12758
2017-02-11,1,85,51,737,873
2017-02-15,4,22256,1375,87106,110737
2017-02-16,9,9916,2327,46289,58532
2017-02-17,3,2129,559,9921,12609
2017-02-18,11,7736,1712,43965,53413
2017-02-19,3,36588,3090,132064,171742
2017-02-23,1,853,219,3778,4850
2017-02-24,5,100,103,1487,1690
2017-02-25,3,6511,1474,32305,40290
2017-02-27,2,33612,3287,77425,114324
2017-02-28,2,4200,375,25176,29751
2017-03-02,1,8614,1083,37279,46976
2017-03-06,3,5052,1525,31170,37747
2017-03-10,3,6900,783,18354,26037
2017-03-11,1,1329,218,3610,5157
2017-03-12,10,6550,1764,35727,44041
2017-03-13,1,84,51,675,810
2017-03-14,3,4742,536,16065,21343
2017-03-16,1,18,66,289,373
2017-03-22,3,547,154,2091,2792
2017-03-23,1,31,34,216,281
2017-03-24,49,32866,6412,122836,162114
2017-03-28,8,5799,1617,23908,31324
2017-03-29,2,722,466,5290,6478
2017-03-30,1,12384,1294,49333,63011
2017-03-31,10,4181,1599,27528,33308
2017-04-01,3,12353,1924,45273,59550
2017-04-02,4,481,203,3234,3918
2017-04-03,3,3624,990,13426,18040
2017-04-05,1,6139,405,21446,27990
2017-04-07,3,1186,881,7273,9340
2017-04-12,4,2053,915,9993,12961
2017-04-13,4,16370,2161,58454,76985
2017-04-17,2,27,69,401,497
2017-04-18,1,14,41,220,275
2017-04-23,2,336,441,3638,4415
2017-04-24,3,28,35,663,726
2017-04-27,1,8,13,159,180
2017-04-28,4,12485,2075,40118,54678
2017-05-01,6,20782,2667,68612,92061
2017-05-04,1,757,382,4696,5835
2017-05-05,11,6181,17671,47808,71660
2017-05-07,2,1541,1027,25367,27935
2017-05-09,2,1493,582,6325,8400
2017-05-10,10,10796,2256,44999,58051
2017-05-11,4,1884,1368,15296,18548
2017-05-12,8,7834,1720,31188,40742
2017-05-13,5,7595,1983,59190,68768
2017-05-14,6,5076,1490,38922,45488
2017-05-16,2,2465,449,9082,11996
2017-05-17,5,13781,2739,64021,80541
2017-05-19,3,321,249,2721,3291
2017-05-21,1,8,31,156,195
2017-05-22,24,5059,1569,34263,40891
2017-05-23,3,570,400,3807,4777
2017-05-24,5,118,104,1454,1676
2017-05-25,3,2488,537,14117,17142
2017-05-26,3,3644,1350,16142,21136
2017-05-27,2,91,51,672,814
2017-05-29,2,182,143,3540,3865
2017-05-31,6,19720,4940,83433,108093
2017-06-01,5,251072,29765,612975,893812
2017-06-02,1,431,138,3787,4356
2017-06-03,1,2028,663,11953,14644
2017-06-04,4,11589,1576,70185,83350
2017-06-05,9,4199,1054,30221,35474
2017-06-06,12,20347,3033,100741,124121
2017-06-07,9,5403,2219,46197,53819
2017-06-08,34,11072,4480,88890,104442
2017-06-09,24,22232,3358,100554,126144
2017-06-10,2,1213,192,6902,8307
2017-06-11,2,103,77,841,1021
2017-06-13,4,4689,847,21500,27036
2017-06-14,1,1080,254,3649,4983
2017-06-16,5,18028,2222,70556,90806
2017-06-17,3,4965,1318,21482,27765
2017-06-18,11,8137,2250,59283,69670
2017-06-19,1,17,31,168,216
2017-06-20,5,5503,946,16919,23368
2017-06-21,3,4325,815,19644,24784
2017-06-22,6,6176,1573,33228,40977
2017-06-23,7,7962,2468,52643,63073
2017-06-24,1,16,60,534,610
2017-06-25,18,12244,2950,77704,92898
2017-06-26,2,5210,480,17583,23273
2017-06-28,3,3352,955,26718,31025
2017-06-29,14,35091,5909,148081,189081
2017-06-30,8,6251,1853,52176,60280
2017-07-02,6,4456,1543,31846,37845
2017-07-03,4,24970,6416,166420,197806
2017-07-04,1,1021,349,8348,9718
2017-07-05,1,1017,495,8674,10186
2017-07-06,2,3720,1311,17061,22092
2017-07-07,1,8814,1375,32743,42932
2017-07-08,2,1091,837,9840,11768
2017-07-09,4,68471,7383,297335,373189
2017-07-11,13,8787,3161,71785,83733
2017-07-12,1,906,429,8557,9892
2017-07-13,6,7046,1288,32957,41291
2017-07-14,13,20645,4956,83405,109006
2017-07-15,2,52,56,1545,1653
2017-07-17,6,5186,1169,29446,35801
2017-07-19,1,499,158,3893,4550
2017-07-20,8,74897,9585,250511,334993
2017-07-21,5,2888,777,19671,23336
2017-07-22,2,156,87,1266,1509
2017-07-25,7,14734,2546,66178,83458
2017-07-26,2,6280,1378,29955,37613
2017-07-27,1,21,28,932,981
2017-07-28,5,5323,1278,28104,34705
2017-07-29,8,5563,1195,53859,60617
2017-07-30,10,9518,2424,50650,62592
2017-07-31,4,10411,1396,68291,80098
2017-08-01,1,3031,520,23076,26627
2017-08-02,4,7965,1644,51403,61012
2017-08-03,1,6102,693,27860,34655
2017-08-04,1,718,347,10001,11066
2017-08-05,5,24357,1541,85374,111272
2017-08-06,8,4879,1991,34038,40908
2017-08-10,1,304,163,3826,4293
2017-08-11,11,7047,1388,55262,63697
2017-08-12,9,51066,6562,179188,236816
2017-08-13,1,1869,746,9198,11813
2017-08-14,6,6704,1841,40659,49204
2017-08-18,3,3349,539,30441,34329
2017-08-19,8,725,580,16478,17783
2017-08-20,4,4969,964,39125,45058
2017-08-21,3,5261,1717,52159,59137
2017-08-22,4,6175,1243,39684,47102
2017-08-23,6,22881,3420,95956,122257
2017-08-25,12,7238,1870,61863,70971
2017-08-26,2,132,98,2220,2450
2017-08-27,11,7039,1232,35207,43478
2017-08-28,17,55301,7037,222327,284665
2017-08-29,1,3523,881,15188,19592
2017-08-30,4,408,314,7866,8588
2017-08-31,5,7334,1783,63079,72196
2017-09-04,9,53044,7162,136276,196482
2017-09-08,1,4050,1265,17917,23232
2017-09-12,2,227,147,4204,4578
2017-09-13,2,14385,1870,71606,87861
2017-09-14,4,11730,1435,41114,54279
2017-09-15,1,32,28,1413,1473
2017-09-16,4,958,644,20707,22309
2017-09-19,1,88,69,1555,1712
2017-09-20,1,3911,256,17319,21486
2017-09-24,1,3135,626,20828,24589
2017-09-25,3,3330,949,23468,27747
2017-09-26,4,6409,1179,38849,46437
2017-09-27,2,2647,1044,21385,25076
2017-09-28,3,5747,803,38128,44678
2017-09-29,7,37281,5838,106829,149948
2017-10-02,2,131,89,1470,1690
2017-10-04,1,3270,1009,23480,27759
2017-10-05,8,26926,3034,151177,181137
2017-10-06,19,12346,3085,81451,96882
2017-10-07,2,5243,940,34186,40369
2017-10-08,6,7115,1600,49608,58323
2017-10-09,1,1053,585,9576,11214
2017-10-11,1,20,18,296,334
2017-10-12,9,2812,1356,27022,31190
2017-10-14,2,2174,1009,18799,21982
2017-10-15,1,1356,388,8244,9988
2017-10-16,2,3999,440,16281,20720
2017-10-18,2,3412,1051,25143,29606
2017-10-19,8,7550,4053,83563,95166
2017-10-20,2,362,120,4468,4950
2017-10-21,3,1891,373,12623,14887
2017-10-24,3,6338,1867,26447,34652
2017-10-26,4,9627,3576,79699,92902
2017-10-28,2,8191,2433,59360,69984
2017-11-07,1,361,167,6894,7422
2017-11-08,1,26467,1880,107787,136134
2017-11-09,2,91275,3641,251973,346889
2017-11-10,1,2495,424,20194,23113
2017-11-12,2,28089,3720,158481,190290
2017-11-13,1,1931,378,12577,14886
2017-11-15,4,15014,3020,87878,105912
2017-11-17,2,132294,11313,553759,697366
2017-11-19,3,15120,4018,102298,121436
2017-11-20,1,19,52,371,442
2017-11-21,1,1365,645,14222,16232
2017-11-23,1,7464,1145,39058,47667
2017-11-24,1,16,31,301,348
2017-11-25,1,363,411,7488,8262
2017-11-26,3,89466,6843,295748,392057
2017-11-27,2,1553,209,13940,15702
2017-11-28,5,43593,5361,184673,233627
2017-11-30,7,10294,2268,60167,72729
2017-12-02,7,25797,5364,140245,171406
2017-12-03,13,10405,5659,90383,106447
2017-12-07,1,21162,1856,102907,125925
2017-12-08,3,4400,1121,31111,36632
2017-12-11,5,14809,3811,140069,158689
2017-12-12,1,1970,2521,24662,29153
2017-12-13,2,19275,2728,92934,114937
2017-12-14,4,1636,1463,23827,26926
2017-12-15,5,6821,1551,59558,67930
2017-12-16,2,1502,2089,24407,27998
2017-12-17,3,132,89,1485,1706
2017-12-19,1,10020,1122,83118,94260
2017-12-20,7,31642,4364,178453,214459
2017-12-21,12,41826,9090,250830,301746
2017-12-23,9,134490,13593,610276,758359
2017-12-24,7,45625,11770,309512,366907
2017-12-25,2,111,102,2938,3151
2017-12-26,12,15476,16343,189072,220891
2017-12-27,1,68,114,2446,2628
2018-01-03,2,10003,4085,74153,88241
2018-01-05,1,19512,2829,118287,140628
2018-01-07,4,16851,4648,190671,212170
2018-01-08,1,3144,807,21010,24961
2018-01-09,2,240,211,9415,9866
2018-01-12,1,43,55,521,619
2018-01-13,1,98,83,929,1110
2018-01-15,2,99,140,1207,1446
2018-01-18,1,45,119,1159,1323
2018-01-24,1,13720,2190,83518,99428
2018-01-27,1,11014,1450,57654,70118
2018-01-28,15,183431,21648,960484,1165563
2018-01-29,8,23026,4089,186955,214070
2018-01-30,1,665,708,18028,19401
2018-01-31,6,14257,3956,142352,160565
2018-02-01,6,33087,6196,304150,343433
2018-02-02,5,70539,5579,366206,442324
2018-02-03,3,29615,5402,259762,294779
2018-02-04,1,6237,682,28295,35214
2018-02-05,8,47927,8349,302874,359150
2018-02-06,13,317005,35853,1196460,1549318
2018-02-07,5,63546,13033,369095,445674
2018-02-11,3,14463,4845,149567,168875
2018-02-12,14,1406,680,15282,17368
2018-02-16,1,826,339,15323,16488
2018-02-17,2,3879,2236,49875,55990
2018-02-18,1,11865,1885,64003,77753
2018-02-20,1,9405,661,63586,73652
2018-02-21,5,12924,2457,110468,125849
2018-02-22,13,31423,6749,280479,318651
2018-02-24,1,984,372,16044,17400
2018-02-25,2,788,269,10361,11418
2018-02-27,6,16672,3982,104133,124787
2018-02-28,1,51,53,785,889
2018-03-03,1,2842,1409,36649,40900
2018-03-04,4,723,330,18137,19190
2018-03-05,1,9734,1541,67333,78608
2018-03-06,2,3388,669,36649,40706
2018-03-07,5,19391,4208,181397,204996
2018-03-08,6,34255,4655,272864,311774
2018-03-09,11,53892,6987,322567,383446
2018-03-10,4,5653,4444,50967,61064
2018-03-11,3,32471,4649,145046,182166
2018-03-12,1,20,61,444,525
2018-03-14,6,5646,3713,81529,90888
2018-03-15,3,2804,734,44124,47662
2018-03-18,1,138,94,6852,7084
2018-03-19,1,925,752,14678,16355
2018-03-20,2,1678,963,25690,28331
2018-03-21,2,4081,872,37021,41974
2018-03-22,11,9384,2101,82111,93596
2018-03-23,20,28942,4968,199477,233387
2018-03-24,2,4220,989,38790,43999
2018-03-25,1,2456,1266,40095,43817
2018-03-26,8,10508,3116,109884,123508
2018-03-27,3,12135,2744,112462,127341
2018-03-28,4,9096,2812,112904,124812
2018-03-30,4,3946,1866,60420,66232
2018-03-31,4,7175,1885,78640,87700
2018-04-01,9,55496,12275,383496,451267
2018-04-02,9,6923,2329,76689,85941
2018-04-04,3,4793,1601,51874,58268
2018-04-05,2,2549,532,16518,19599
2018-04-06,4,22368,3906,118917,145191
2018-04-07,2,2515,742,17748,21005
2018-04-08,9,2735,1090,44242,48067
2018-04-09,3,5478,2031,39368,46877
2018-04-10,2,295,239,2642,3176
2018-04-11,1,20,50,578,648
2018-04-12,2,409,259,8614,9282
2018-04-13,6,9358,1985,61107,72450
2018-04-15,6,27090,6165,219079,252334
2018-04-16,2,6177,2145,70443,78765
2018-04-17,3,2961,2198,31629,36788
2018-04-18,3,33938,2297,163263,199498
2018-04-23,1,18,29,437,484
2018-04-25,4,99712,16033,483200,598945
2018-04-26,2,8681,1050,67016,76747
2018-04-27,1,1959,427,26389,28775
2018-04-28,2,933,197,4484,5614
2018-04-30,2,2961,1982,41509,46452
2018-05-01,1,211,121,5065,5397
2018-05-02,6,8447,2483,82216,93146
2018-05-03,1,574,409,10043,11026
2018-05-04,17,12335,4918,167881,185134
2018-05-05,11,68392,29125,565700,663217
2018-05-06,7,26103,4769,167461,198333
2018-05-07,4,5691,2461,61274,69426
2018-05-08,3,1469,187,8134,9790
2018-05-09,12,3548,2001,60139,65688
2018-05-10,7,2651,930,28947,32528
2018-05-11,15,8064,2940,77562,88566
2018-05-12,4,2951,999,48470,52420
2018-05-13,3,1282,418,12739,14439
2018-05-14,10,40917,7083,294914,342914
2018-05-16,3,3638,1419,44498,49555
2018-05-17,3,5620,1932,48664,56216
2018-05-18,8,14173,3597,133691,151461
2018-05-19,1,3613,1305,42014,46932
2018-05-20,24,18710,5836,211525,236071
2018-05-21,16,4224,1498,41235,46957
2018-05-22,30,14593,19760,240431,274784
2018-05-23,35,105344,33156,623254,761754
2018-05-24,29,29772,10187,331332,371291
2018-05-25,21,10396,6948,105976,123320
2018-05-26,38,22359,8824,232950,264133
2018-05-27,15,7819,3864,55727,67410
2018-05-28,10,1311,711,16769,18791
2018-05-29,25,11914,4503,168828,185245
2018-05-30,13,4856,1868,57010,63734
2018-05-31,12,32789,3502,270059,306350
2018-06-01,10,15439,3021,163152,181612
2018-06-02,15,10157,3692,104730,118579
2018-06-03,6,695,379,12148,13222
2018-06-04,2,7200,1121,55112,63433
2018-06-05,2,100,108,2582,2790
2018-06-06,2,60,104,1694,1858
2018-06-07,5,1080,561,16057,17698
2018-06-08,7,10691,2385,106986,120062
2018-06-09,15,52552,8851,410632,472035
2018-06-10,24,7035,2779,116708,126522
2018-06-11,2,70,70,1769,1909
2018-06-12,2,10195,1987,71146,83328
2018-06-13,3,989,439,14512,15940
2018-06-14,1,977,121,10698,11796
2018-06-15,19,84995,15421,436546,536962
2018-06-16,22,24017,11690,238377,274084
2018-06-17,48,19814,6550,178725,205089
2018-06-18,4,371,291,5820,6482
2018-06-19,33,5968,4096,96451,106515
2018-06-20,13,1438,849,26372,28659
2018-06-21,5,10165,2685,96431,109281
2018-06-22,16,2616,2198,49852,54666
2018-06-23,17,18913,7166,244574,270653
2018-06-24,8,6266,958,54474,61698
2018-06-25,25,13710,4518,120242,138470
2018-06-26,8,10412,31024,128520,169956
2018-06-27,15,3443,1382,54712,59537
2018-06-28,11,3269,4172,73080,80521
2018-06-29,20,40790,8621,287030,336441
2018-06-30,1,54,133,1537,1724
2018-07-01,1,12972,4833,143059,160864
2018-07-02,3,319,169,10228,10716
2018-07-03,2,4340,1341,38881,44562
2018-07-04,10,8357,1376,44076,53809
2018-07-05,30,6457,2961,85402,94820
2018-07-06,20,14399,3149,77267,94815
2018-07-07,12,47038,6125,314750,367913
2018-07-08,27,72785,8658,425927,507370
2018-07-09,6,102546,10323,389901,502770
2018-07-10,14,46251,8436,283077,337764
2018-07-11,24,38592,8347,268919,315858
2018-07-12,19,10897,4999,159571,175467
2018-07-13,6,2974,1738,40927,45639
2018-07-14,14,5886,4660,89446,99992
2018-07-15,5,9857,7786,112669,130312
2018-07-17,1,53,175,1398,1626
2018-07-18,4,4338,3596,51458,59392
2018-07-20,5,848,763,15795,17406
2018-07-21,18,5106,2494,66948,74548
2018-07-22,1,47,65,749,861
2018-07-23,9,2246,1308,30083,33637
2018-07-24,1,17,41,606,664
2018-07-25,5,2494,1435,36976,40905
2018-07-26,2,3058,994,28326,32378
2018-07-27,3,612,616,14649,15877
2018-07-28,4,1157,555,18984,20696
2018-07-29,6,16790,7871,116315,140976
2018-07-30,8,4264,2700,56092,63056
2018-07-31,12,6493,3101,82904,92498
2018-08-01,19,21323,8693,191349,221365
2018-08-02,1,24,55,574,653
2018-08-04,2,1641,871,27437,29949
2018-08-05,18,5034,2750,55994,63778
2018-08-06,2,226,157,2413,2796
2018-08-07,12,27338,14965,212452,254755
2018-08-08,4,1330,666,13254,15250
2018-08-10,3,404,308,8703,9415
2018-08-11,15,34762,7925,261064,303751
2018-08-12,1,3029,866,30741,34636
2018-08-13,4,577,344,17017,17938
2018-08-14,4,1758,1227,20887,23872
2018-08-16,4,13723,3885,114255,131863
2018-08-18,2,6494,2109,98600,107203
2018-08-19,2,3593,1718,41770,47081
2018-08-21,5,5524,3296,64005,72825
2018-08-22,3,357,251,11432,12040
2018-08-23,6,5859,2382,61906,70147
2018-08-24,3,6071,1921,68496,76488
2018-08-25,13,11947,5113,121696,138756
2018-08-26,1,8685,1575,88214,98474
2018-08-27,1,15,59,580,654
2018-08-28,10,3243,3262,36731,43236
2018-08-29,1,118,71,6534,6723
2018-08-30,1,381,609,7862,8852
2018-08-31,3,4226,1530,55466,61222
2018-09-03,1,737,311,13180,14228
2018-09-05,2,16077,3123,100876,120076
2018-09-06,1,1397,728,13394,15519
2018-09-07,6,13894,5273,115303,134470
2018-09-08,5,13190,3845,149131,166166
2018-09-11,4,5326,2009,71995,79330
2018-09-12,3,1666,1528,34773,37967
2018-09-13,5,4599,1617,55584,61800
2018-09-14,9,8196,2182,89835,100213
2018-09-15,2,2277,1240,19410,22927
2018-09-16,6,2909,1453,50765,55127
2018-09-17,25,41526,8587,413603,463716
2018-09-18,16,43308,8647,360937,412892
2018-09-19,8,6325,2512,66080,74917
2018-09-20,14,3474,1466,55322,60262
2018-09-21,2,43293,6856,314697,364846
2018-09-22,1,339,345,2804,3488
2018-09-24,2,283,403,5162,5848
2018-09-25,4,3138,2908,63798,69844
2018-09-26,3,1202,454,13492,15148
2018-09-28,5,23030,4977,217663,245670
2018-09-29,3,3664,1097,42859,47620
2018-10-01,1,2550,1678,24934,29162
2018-10-02,3,645,634,10589,11868
2018-10-04,13,17611,8112,158454,184177
2018-10-05,16,5687,3187,57016,65890
2018-10-06,8,3550,1600,34291,39441
2018-10-07,1,638,473,10502,11613
2018-10-08,4,41198,3919,341119,386236
2018-10-09,8,6462,1650,40770,48882
2018-10-10,3,9736,3013,105930,118679
2018-10-11,2,587,220,7938,8745
2018-10-12,8,47292,9432,325624,382348
2018-10-13,5,1867,809,40532,43208
2018-10-14,8,102893,15697,432243,550833
2018-10-15,8,13974,4400,177805,196179
2018-10-16,7,2823,848,30037,33708
2018-10-17,7,4057,3077,77118,84252
2018-10-18,12,15350,7591,190460,213401
2018-10-19,7,410305,20504,1396766,1827575
2018-10-20,9,11413,1801,136668,149882
2018-10-21,7,48668,5782,249372,303822
2018-10-22,17,182378,19647,806045,1008070
2018-10-23,9,23450,5700,313250,342400
2018-10-25,20,197539,66770,1294946,1559255
2018-10-26,17,48219,10273,376072,434564
2018-10-27,27,20294,6815,259907,287016
2018-10-29,3,10421,4921,165639,180981
2018-10-31,3,6596,1336,86940,94872
2018-11-01,10,12912,3727,149371,166010
2018-11-02,13,11487,2176,105708,119371
2018-11-03,23,54107,11731,550923,616761
2018-11-06,9,46473,10849,462346,519668
2018-11-07,7,8598,7103,195669,211370
2018-11-08,1,574,386,18755,19715
2018-11-09,6,2608,23006,71027,96641
2018-11-10,7,69013,7059,385634,461706
2018-11-11,2,5562,1308,56329,63199
2018-11-12,2,84422,1909,464139,550470
2018-11-14,8,5613,1758,84302,91673
2018-11-15,17,25577,8789,281695,316061
2018-11-16,3,3912,1516,31684,37112
2018-11-17,9,29052,6672,289459,325183
2018-11-19,20,6486,2799,97696,106981
2018-11-20,6,5426,3467,73802,82695
2018-11-21,8,4862,2102,66191,73155
2018-11-22,1,508,780,20695,21983
2018-11-23,1,3887,2202,31115,37204
2018-11-25,1,65,75,934,1074
2018-11-26,15,57003,21945,484394,563342
2018-11-27,4,6238,2194,66829,75261
2018-11-28,2,2367,1105,35308,38780
2018-11-29,13,38228,8634,361564,408426
2018-11-30,5,1095,468,11995,13558
2018-12-01,17,19521,1961,177745,199227
2018-12-02,4,3258,1702,68384,73344
2018-12-03,4,5462,2337,81010,88809
2018-12-04,1,26,69,876,971
2018-12-05,7,40987,8557,296843,346387
2018-12-07,1,6206,1356,64302,71864
2018-12-08,1,158,124,2833,3115
2018-12-09,16,17975,5553,216324,239852
2018-12-11,16,17303,6388,217000,240691
2018-12-12,1,332,226,17286,17844
2018-12-13,1,475,345,10101,10921
2018-12-14,5,71381,7074,340194,418649
2018-12-15,5,12220,2275,131038,145533
2018-12-16,4,6995,2059,106806,115860
2018-12-17,1,373,210,8571,9154
2018-12-18,8,6633,2287,86574,95494
2018-12-19,28,33748,11404,395688,440840
2018-12-20,8,4060,2154,71868,78082
2018-12-21,7,50459,8535,281222,340216
2018-12-22,24,5517,2625,89788,97930
2018-12-23,11,67762,9791,506244,583797
2018-12-24,12,9813,3055,147918,160786
2018-12-25,6,17520,5211,217355,240086
2018-12-26,13,10285,5202,104330,119817
2018-12-27,13,1020,524,19584,21128
2018-12-28,2,2356,1139,39186,42681
2018-12-30,2,1186,436,18550,20172
2018-12-31,3,15889,5290,168743,189922
2019-01-01,4,34171,7464,272494,314129
2019-01-03,15,181542,10939,878023,1070504
2019-01-04,10,22553,9493,194096,226142
2019-01-05,16,24498,7478,251240,283216
2019-01-06,3,14995,2848,164745,182588
2019-01-07,8,40677,10760,447773,499210
2019-01-08,1,7105,2380,113573,123058
2019-01-09,14,30277,8877,261176,300330
2019-01-10,5,3466,1177,41742,46385
2019-01-11,11,35409,9329,312518,357256
2019-01-12,1,22,69,766,857
2019-01-13,5,8447,2047,140190,150684
2019-01-14,2,5966,2652,121440,130058
2019-01-15,1,30698,2212,336611,369521
2019-01-16,5,1926,873,39714,42513
2019-01-17,7,3581,3392,71647,78620
2019-01-18,1,109,103,5813,6025
2019-01-19,4,2187,1180,53372,56739
2019-01-21,5,18845,4151,212725,235721
2019-01-22,7,7677,3299,131858,142834
2019-01-23,4,1277,927,21793,23997
2019-01-25,16,17118,7056,277330,301504
2019-01-26,1,80,50,1077,1207
2019-01-27,10,156622,25261,1116975,1298858
2019-01-28,5,38986,5044,348616,392646
2019-01-29,1,21,55,914,990
2019-01-30,6,89247,8769,404409,502425
2019-01-31,12,11054,3394,153992,168440
2019-02-01,19,29826,7645,258590,296061
2019-02-02,8,63416,6814,482496,552726
2019-02-03,7,45263,5365,367045,417673
2019-02-04,5,51947,8071,424349,484367
2019-02-05,2,1582,1199,66869,69650
2019-02-06,4,1494,879,21175,23548
2019-02-07,9,21257,5255,294082,320594
2019-02-08,5,24828,2316,199465,226609
2019-02-09,5,70068,6486,463606,540160
2019-02-10,1,194,144,5619,5957
2019-02-11,20,10474,3073,156572,170119
2019-02-12,2,4908,1557,75036,81501
2019-02-13,7,23846,3828,177733,205407
2019-02-14,9,6275,2763,123449,132487
2019-02-15,1,15283,2339,238041,255663
2019-02-16,3,12196,3096,190121,205413
2019-02-17,5,1773,1230,63815,66818
2019-02-18,2,13559,2641,129469,145669
2019-02-19,1,629,403,25155,26187
2019-02-20,4,29255,9071,406817,445143
2019-02-21,24,5189,2801,87378,95368
2019-02-22,14,56278,4931,429856,491065
2019-02-23,2,24875,2112,228293,255280
2019-02-25,3,36197,3781,361654,401632
2019-02-26,11,48077,4168,408133,460378
2019-02-27,11,44827,12554,586736,644117
2019-02-28,5,1908,909,51925,54742
2019-03-01,11,17469,6531,230293,254293
2019-03-02,19,31903,6796,360461,399160
2019-03-03,27,48319,13852,580342,642513
2019-03-04,2,457,381,15947,16785
2019-03-05,4,4682,1028,113133,118843
2019-03-06,3,114601,11407,913177,1039185
2019-03-07,14,48824,5909,422125,476858
2019-03-08,9,7304,2518,129997,139819
2019-03-09,8,12508,2190,198043,212741
2019-03-11,7,799,638,32613,34050
2019-03-12,18,4895,3977,90548,99420
2019-03-13,3,212,291,10388,10891
2019-03-14,7,37552,5462,291231,334245
2019-03-15,6,3495,2038,67385,72918
2019-03-16,14,10358,6613,181119,198090
2019-03-17,19,14478,5406,207360,227244
2019-03-20,1,43,74,1185,1302
2019-03-21,8,1074,1068,19236,21378
2019-03-22,11,3318,2023,45673,51014
2019-03-24,6,2495,2361,67003,71859
2019-03-25,2,4240,1284,37336,42860
2019-03-26,11,8131,4288,132842,145261
2019-03-27,3,395,377,15387,16159
2019-03-28,2,303,462,13541,14306
2019-03-29,7,1762,1367,26883,30012
2019-03-30,30,76027,16232,878311,970570
2019-03-31,5,2620,1119,48244,51983
2019-04-01,16,11852,3460,155213,170525
2019-04-02,8,24447,4911,245566,274924
2019-04-03,10,5358,2683,86880,94921
2019-04-04,8,3206,1225,42209,46640
2019-04-05,22,45368,5274,281795,332437
2019-04-06,14,20034,4120,198807,222961
2019-04-07,9,7461,2174,127978,137613
2019-04-08,8,6422,1623,69023,77068
2019-04-09,5,3750,1262,44123,49135
2019-04-10,11,5863,2808,97163,105834
2019-04-11,5,24439,3883,220066,248388
2019-04-12,18,10059,4188,183571,197818
2019-04-13,19,9773,6373,136883,153029
2019-04-14,33,32282,8034,457108,497424
2019-04-15,8,10898,3670,151303,165871
2019-04-16,7,705,653,18939,20297
2019-04-17,2,8142,1122,80877,90141
2019-04-18,2,64,154,2761,2979
2019-04-19,30,133494,22746,1291317,1447557
2019-04-20,6,18584,4234,188760,211578
2019-04-21,8,78791,10916,573847,663554
2019-04-22,4,39690,5027,338033,382750
2019-04-23,41,52087,20482,713359,785928
2019-04-24,16,27901,8459,386912,423272
2019-04-25,7,5092,3607,110333,119032
2019-04-26,6,1515,1199,32961,35675
2019-04-27,8,602,691,21206,22499
2019-04-28,5,1590,696,41526,43812
2019-04-29,26,76765,10583,631074,718422
2019-04-30,9,22532,13666,276386,312584
2019-05-01,2,322,588,17661,18571
2019-05-03,7,23448,6915,333843,364206
2019-05-04,7,4916,2296,99138,106350
2019-05-05,11,3373,2176,62811,68360
2019-05-06,8,8661,2411,147350,158422
2019-05-07,10,4588,2901,95644,103133
2019-05-08,6,1587,1628,33488,36703
2019-05-09,17,32995,5228,337594,375817
2019-05-10,15,32923,7758,509613,550294
2019-05-11,3,1606,690,29221,31517
2019-05-12,11,13627,3808,197319,214754
2019-05-13,4,5862,1447,95505,102814
2019-05-14,4,753,617,23294,24664
2019-05-15,4,843,544,18533,19920
2019-05-16,8,9506,2772,119921,132199
2019-05-17,6,165840,6943,949289,1122072
2019-05-18,5,19056,4088,200562,223706
2019-05-19,16,14781,6462,233918,255161
2019-05-21,6,793,753,29991,31537
2019-05-22,6,18260,6609,178839,203708
2019-05-23,27,3697,2300,70768,76765
2019-05-24,29,26457,7854,329735,364046
2019-05-25,21,37151,7289,410397,454837
2019-05-26,1,71,98,3285,3454
2019-05-27,9,1026,780,17535,19341
2019-05-28,3,269,345,8109,8723
2019-05-29,4,2141,978,42093,45212
2019-05-30,9,1436,1019,47140,49595
2019-05-31,14,38870,9736,476767,525373
2019-06-01,4,9274,1438,58081,68793
2019-06-02,1,127,146,4604,4877
2019-06-03,1,199,150,5621,5970
2019-06-04,6,596,1016,18868,20480
2019-06-05,1,44,85,818,947
2019-06-07,1,1511,718,20564,22793
2019-06-09,2,93,122,2149,2364
2019-06-10,5,3452,1577,64474,69503
2019-06-11,3,4455,791,57774,63020
2019-06-12,4,7727,2911,97151,107789
2019-06-13,8,19413,2934,272338,294685
2019-06-14,4,2342,1624,30832,34798
2019-06-15,16,56718,6281,492903,555902
2019-06-16,5,1616,1205,35136,37957
2019-06-17,7,418,477,10497,11392
2019-06-18,5,30661,2889,250948,284498
2019-06-19,10,3911,4488,90617,99016
2019-06-20,8,95199,7143,651047,753389
2019-06-21,7,2041,1004,52122,55167
2019-06-22,2,4380,662,37334,42376
2019-06-23,8,51963,10293,426969,489225
2019-06-24,26,12413,4833,176685,193931
2019-06-25,22,4752,3194,97165,105111
2019-06-26,19,1234,1227,30265,32726
2019-06-27,6,1414,1120,25273,27807
2019-06-28,14,18958,23771,424486,467215
2019-06-29,2,6571,2370,164564,173505
2019-06-30,2,413,287,11056,11756
2019-07-01,3,2263,1548,37843,41654
2019-07-02,7,9653,2771,122771,135195
2019-07-03,6,3746,1445,61108,66299
2019-07-04,2,4579,1054,59435,65068
2019-07-06,6,14217,2011,151375,167603
2019-07-07,10,5667,2453,65637,73757
2019-07-08,21,3413,2054,85723,91190
2019-07-09,17,3468,2338,106059,111865
2019-07-10,3,10892,1907,90051,102850
2019-07-11,4,5931,2287,71258,79476
2019-07-12,12,3873,2007,85461,91341
2019-07-13,12,2803,1620,89926,94349
2019-07-14,3,65597,3308,416299,485204
2019-07-15,2,131,189,2943,3263
2019-07-16,15,23648,5282,190503,219433
2019-07-17,12,85597,5218,539708,630523
2019-07-18,15,1524,1191,37835,40550
2019-07-19,5,39317,2578,292454,334349
2019-07-20,5,268,239,5487,5994
2019-07-21,6,177787,8440,752790,939017
2019-07-22,21,99189,15023,873758,987970
2019-07-23,2,292,246,13882,14420
2019-07-24,3,2065,407,30696,33168
2019-07-25,9,6560,2261,121881,130702
2019-07-26,7,16583,3862,194417,214862
2019-07-27,14,19589,5286,305077,329952
2019-07-28,21,33520,5828,292396,331744
2019-07-29,1,1912,649,17617,20178
2019-07-30,1,211,243,2344,2798
2019-07-31,5,401,530,14489,15420
2019-08-01,5,51150,3031,299646,353827
2019-08-02,2,62,78,1611,1751
2019-08-03,5,2074,1080,49162,52316
2019-08-04,32,107448,13534,834420,955402
2019-08-05,2,4018,1276,74144,79438
2019-08-06,7,1286,1004,33323,35613
2019-08-07,8,24776,4752,255984,285512
2019-08-08,5,452,301,8020,8773
2019-08-09,27,8372,4788,150517,163677
2019-08-10,6,24948,3846,164899,193693
2019-08-11,6,3066,1910,37556,42532
2019-08-13,1,20,52,710,782
2019-08-14,2,20837,2145,204688,227670
2019-08-15,13,32516,5111,315077,352704
2019-08-16,9,37507,11491,445491,494489
2019-08-17,6,18036,8771,274695,301502
2019-08-18,19,39685,15616,554514,609815
2019-08-19,3,5110,3384,106317,114811
2019-08-20,16,8038,6210,144622,158870
2019-08-21,2,311,280,15639,16230
2019-08-23,1,301,146,16653,17100
2019-08-24,15,7078,3664,104838,115580
2019-08-25,1,41,76,1585,1702
2019-08-26,6,5730,2286,107584,115600
2019-08-27,13,18913,6317,235700,260930
2019-08-28,10,5288,3255,107639,116182
2019-08-29,3,246,228,5136,5610
2019-08-30,7,58659,3154,410680,472493
2019-09-03,6,1441,1657,21998,25096
2019-09-04,5,5073,1887,79278,86238
2019-09-05,9,21049,7080,303143,331272
2019-09-06,7,839,818,17026,18683
2019-09-07,23,41134,4976,402448,448558
2019-09-08,2,391,514,11839,12744
2019-09-09,22,20732,7042,244941,272715
2019-09-10,14,3311,1711,75127,80149
2019-09-11,11,63708,4388,426245,494341
2019-09-12,17,7710,5131,156706,169547
2019-09-13,6,2014,1242,30183,33439
2019-09-14,16,2993,2213,51888,57094
2019-09-15,9,2124,2058,42173,46355
2019-09-16,7,510,637,11149,12296
2019-09-17,21,15361,3844,238799,258004
2019-09-18,10,15681,2892,165329,183902
2019-09-19,10,5532,1783,66112,73427
2019-09-20,3,2412,696,21021,24129
2019-09-21,6,536,515,12062,13113
2019-09-22,13,11492,2776,144212,158480
2019-09-23,8,6733,2768,110660,120161
2019-09-24,18,60610,3429,390990,455029
2019-09-25,3,680,322,8087,9089
2019-09-26,24,29895,9040,376132,415067
2019-09-27,15,36918,9891,399232,446041
2019-09-28,5,27587,3922,211902,243411
2019-09-29,1,52,125,1559,1736
2019-09-30,2,210,250,4220,4680
2019-10-01,17,8611,2954,132591,144156
2019-10-02,8,2576,1868,60089,64533
2019-10-03,4,849,1117,12604,14570
2019-10-04,6,4109,1659,55163,60931
2019-10-05,5,302,390,6718,7410
2019-10-06,8,6441,6624,100595,113660
2019-10-07,9,14413,3823,204446,222682
2019-10-08,6,2012,972,25252,28236
2019-10-09,26,65533,18011,646155,729699
2019-10-10,7,3511,1663,67719,72893
2019-10-11,1,183,318,4094,4595
2019-10-12,23,13408,6090,163229,182727
2019-10-13,11,88605,13339,682753,784697
2019-10-14,27,3890,2147,75478,81515
2019-10-15,7,32586,6211,308608,347405
2019-10-16,3,3019,1181,44749,48949
2019-10-17,5,7324,8269,149002,164595
2019-10-21,3,3038,1889,42151,47078
2019-10-22,5,40371,8949,450779,500099
2019-10-23,5,8387,3254,111352,122993
2019-10-24,11,75950,5281,498215,579446
2019-10-25,10,30603,9163,362810,402576
2019-10-26,4,47815,3885,375731,427431
2019-10-27,2,4945,2502,154955,162402
2019-10-28,17,19454,5826,379720,405000
2019-10-29,1,59658,4111,371074,434843
2019-10-30,15,77016,6822,832940,916778
2019-10-31,2,513,368,6618,7499
2019-11-01,2,5835,1569,98586,105990
2019-11-04,4,4233,1708,58246,64187
2019-11-05,5,930,678,13322,14930
2019-11-06,9,9259,3432,114591,127282
2019-11-07,11,2591,1205,26618,30414
2019-11-08,9,5693,2094,76104,83891
2019-11-09,2,359,324,4872,5555
2019-11-10,4,366,446,10053,10865
2019-11-11,1,6504,1101,79534,87139
2019-11-12,3,7854,3557,106885,118296
2019-11-13,4,2202,1016,30115,33333
2019-11-14,9,2494,2168,29694,34356
2019-11-15,3,10853,1691,150699,163243
2019-11-16,3,6284,2239,65206,73729
2019-11-18,5,1904,860,22055,24819
2019-11-19,9,12259,7000,165737,184996
2019-11-20,3,1237,1057,26364,28658
2019-11-21,7,19217,5793,247092,272102
2019-11-22,10,69008,28903,683032,780943
2019-11-23,13,80335,23267,1034947,1138549
2019-11-24,22,163946,30788,1418445,1613179
2019-11-25,5,21184,10616,440762,472562
2019-11-26,3,848,764,29076,30688
2019-11-27,7,37938,6779,480533,525250
2019-11-29,1,383,186,13247,13816
2019-12-01,12,27291,18773,578798,624862
2019-12-02,2,58042,10971,527431,596444
2019-12-03,4,619,700,21156,22475
2019-12-04,1,2271,738,34417,37426
2019-12-07,13,47218,13550,569058,629826
2019-12-08,1,661,777,12450,13888
2019-12-09,1,280,202,13871,14353
2019-12-10,6,3918,1442,75865,81225
2019-12-11,1,50,52,1549,1651
2019-12-12,17,247879,24779,1620754,1893412
2019-12-13,5,136142,5440,794375,935957
2019-12-14,3,70787,6019,571648,648454
2019-12-17,3,932,1308,31354,33594
2019-12-18,5,18175,2544,148114,168833
2019-12-19,8,26175,5068,318272,349515
2019-12-20,5,4232,2514,88083,94829
2019-12-21,10,24476,3271,278866,306613
2019-12-22,27,29700,8854,546875,585429
2019-12-23,3,63534,13891,630016,707441
2019-12-24,7,580,833,14012,15425
2019-12-26,20,6458,4614,163744,174816
2019-12-27,2,6730,2426,113542,122698
2019-12-28,19,14726,16855,219374,250955
2019-12-29,24,45314,9131,423664,478109
2019-12-30,47,32460,9123,352025,393608
2019-12-31,4,827,798,21331,22956
2020-01-01,3,31542,6199,386506,424247
2020-01-04,3,502,512,10902,11916
2020-01-05,4,32076,2513,322905,357494
2020-01-06,2,215,178,3651,4044
2020-01-07,13,44445,9930,431728,486103
2020-01-08,2,3287,1838,100397,105522
2020-01-09,2,67746,8454,479266,555466
2020-01-10,15,70724,8690,641004,720418
2020-01-11,6,9325,3028,140727,153080
2020-01-12,10,17415,5364,236687,259466
2020-01-13,1,221,142,3602,3965
2020-01-14,7,4739,3563,79367,87669
2020-01-15,1,272,372,13406,14050
2020-01-16,6,5166,1988,90530,97684
2020-01-17,20,47977,8722,423965,480664
2020-01-18,2,40366,3879,409327,453572
2020-01-19,3,6417,2362,122331,131110
2020-01-20,3,2197,997,46041,49235
2020-01-21,6,1082,608,19211,20901
2020-01-22,11,13937,6683,214904,235524
2020-01-23,7,2439,1521,44921,48881
2020-01-24,1,12482,2522,162618,177622
2020-01-25,11,18656,3404,201595,223655
2020-01-26,2,201,181,6936,7318
2020-01-27,3,1771,786,34231,36788
2020-01-28,5,40610,9017,497916,547543
2020-01-29,10,43445,7591,487733,538769
2020-01-30,5,27453,7669,341417,376539
2020-01-31,15,98256,16083,1012842,1127181
2020-02-01,7,10064,3748,83587,97399
2020-02-02,14,17490,11946,242378,271814
2020-02-03,16,15229,6646,218866,240741
2020-02-04,4,5628,3985,115754,125367
2020-02-05,10,28182,14167,359391,401740
2020-02-06,25,65228,18368,782371,865967
2020-02-07,7,3153,1470,58435,63058
2020-02-08,11,18541,5487,266410,290438
2020-02-09,5,11861,5399,205890,223150
2020-02-10,21,11741,8310,232608,252659
2020-02-12,6,25173,3268,379696,408137
2020-02-13,2,15990,1761,137537,155288
2020-02-14,8,23745,3435,166135,193315
2020-02-15,19,12700,6263,204396,223359
2020-02-16,3,6473,3548,78125,88146
2020-02-17,4,571,284,6855,7710
2020-02-18,5,1170,1194,22711,25075
2020-02-19,5,8527,2542,171851,182920
2020-02-20,16,4933,3248,80666,88847
2020-02-21,4,74616,7302,588510,670428
2020-02-22,5,3419,2292,64034,69745
2020-02-25,14,70099,9754,690115,769968
2020-02-26,9,3974,2002,72583,78559
2020-02-27,2,774,801,20793,22368
2020-02-28,2,678,715,9435,10828
